1111111111111111111111111111111111
1E0000000000000C00000C000CC0000001
101001010010000010100100C00C010101
101001001010101000100100CCCC010101
1P0000000C00C00000000000CCCC0000C1
1111111111111111111111111111111111
