1111111111111
10010000111C1
1010010001101
1P0011E000021
1111111111111
