11111111111111111111
1CCC0000000C00000001
1CC2C00000CCC0000001
100C0000000C00000001
10000CCC00000200CC01
100000000000C0000001
10000000000CCC000001
1000CC000020C0000001
1000CC00000000000001
1000CC00E00000000001
10000000000C00000001
10000000000C00000001
100C0000000000C0C001
10C2C000000000000001
100C0000000000000P01
11111111111111111111
